######################..##......##.....########################......###############################
#######..#############..##......##......###############......##......###############################
######....#######.......##......##.......###...#######.......##......###############################
#####......#####........##......##..##....#.....#####....##..##..#...##.#########....###############
.......##...###...####..##......##..##...........###....###......##...#..#######......######........
.............#...#####......##......##......##....#....####......##.......#####...##...####.........
########........######......##......##.....####.......#####......##........###...####...##...#######
############...#######......##......##....######.....##################.....#...######......########
#############........#############.......########.....##################.......########....#########
##############.......##############.....##########............................######################
....................................................................................................
....................................................................................................
....................................................................................................
....................................................................................................
....................................................................................................
....................................................................................................
....................................................................................................
....................................................................................................
....................................................................................................
....................................................................................................
....................................................................................................
