9,9,9,9,9,9,9,12,13,14,9,9,9,9,12,9,9,9,9,9,9,9,9,9,12,12,12,13,14,9,9,9,9,9,9,9,9,9,9,12,13,14,12,13,12,13,14,9,9,9,9,9,12,12,13,14,9,9,9,12,13,12,12,12,13,14,9,9,9,9,9,9,9,9,9,9,9,9,9,9,9,9,9,9,9,9,9,9,9,9,9,9,9,9,9,9,9,9,9,9
9,9,9,9,9,9,12,13,14,14,9,9,9,9,12,12,9,9,9,9,9,9,9,12,13,14,14,12,13,14,9,9,9,9,9,9,9,9,9,12,13,12,12,13,12,13,14,9,9,9,9,9,12,12,13,14,9,9,9,12,13,14,12,12,13,14,9,9,9,9,12,13,12,12,12,13,12,13,14,12,13,14,12,12,12,12,12,12,12,13,14,9,9,9,9,9,9,9,9,9
9,9,9,9,9,12,13,12,13,14,9,9,9,9,12,12,13,14,9,9,9,12,13,12,13,14,9,9,12,13,14,-1,9,9,9,9,9,9,9,12,13,14,12,13,12,13,14,9,9,12,9,12,13,12,12,13,14,9,12,12,13,14,12,12,13,14,9,9,9,9,12,13,14,14,12,13,12,13,14,9,9,9,9,9,9,9,12,13,12,13,14,9,9,9,9,9,9,9,9,9
9,9,9,9,9,12,13,14,14,14,9,9,17,18,19,20,21,17,18,19,20,21,12,13,14,9,9,9,9,9,12,13,14,9,9,9,9,9,9,12,12,9,9,9,9,12,12,9,9,12,12,13,14,12,12,13,14,12,13,14,9,9,9,9,12,12,9,9,9,9,12,13,14,12,13,14,14,12,9,9,9,9,9,9,9,9,9,9,12,13,14,9,9,9,12,13,14,9,9,9
16,17,18,19,20,21,22,12,13,14,9,9,17,18,19,20,21,22,23,19,20,21,22,23,9,9,9,9,9,9,9,12,13,14,9,9,9,9,12,12,9,9,9,9,9,12,13,14,9,12,12,13,14,9,9,12,13,12,13,14,9,9,9,9,12,13,14,12,13,12,13,14,9,9,12,9,9,12,9,9,9,9,9,9,9,9,9,9,9,12,13,14,12,13,12,12,12,12,13,14
9,9,9,9,9,17,18,19,20,21,22,12,13,14,9,12,12,9,9,9,9,9,9,9,9,9,9,9,9,9,9,9,12,13,14,12,13,12,13,14,9,9,9,9,9,9,9,12,12,13,14,9,9,9,9,9,9,12,13,14,9,9,9,9,12,13,14,12,13,14,12,9,9,9,9,9,9,9,9,9,9,9,9,9,9,9,9,9,12,13,14,9,9,9,9,9,9,9,9,9
9,9,9,9,9,9,17,18,19,20,21,22,23,9,9,12,12,9,9,9,9,9,9,9,9,9,9,9,9,9,9,9,9,12,13,14,12,13,14,9,9,9,9,9,9,9,9,9,12,12,9,9,9,9,9,9,9,9,12,12,9,9,9,9,12,13,14,9,9,9,12,12,9,9,9,9,9,9,9,9,9,9,9,9,9,9,9,12,13,9,9,9,9,9,9,9,9,9,9,9
9,9,9,9,9,9,17,18,19,20,21,22,23,9,9,12,12,9,9,9,9,9,9,9,9,9,9,9,9,9,9,9,9,9,12,9,9,9,9,9,9,9,9,9,9,9,9,9,9,9,9,9,9,9,9,9,9,9,9,9,9,9,9,9,9,9,9,9,9,9,9,9,9,9,9,9,9,9,9,9,9,9,9,9,9,9,12,13,9,9,9,9,9,9,9,9,9,9,9,9
9,9,9,9,9,9,9,12,12,13,12,13,14,9,9,17,18,19,20,21,22,23,12,9,9,9,9,9,9,9,9,9,9,9,12,13,14,12,13,12,12,12,12,12,12,13,12,12,13,14,12,12,12,12,12,12,12,12,12,12,12,13,14,13,14,12,12,13,12,13,14,12,12,13,14,12,13,14,12,13,14,13,12,12,12,12,13,14,9,9,9,9,9,9,9,9,9,9,9,9
