######################..##......##.....########################......###############################
#######..#############..##......##.....################......##......###############################
######....########......##......##.....#####...#######....#..##......###############################
#####......#####........##......##..##...##.....#####....##..##..##..##.##########..################
.......##...###..#####..##..##..##..##.......#...###....###......##..##..########....#######........
......####...#...#####......##..##..##......###...#....####......##.......######..##..#####.........
###########.....######......##......##.....#####......#####......##........####..####..###..########
############...#######......##......##....#######....####################...##..######......########
#############........#......##...........#########..######################.....########...##########
##############.......#......##......##..##########............................######################
####################################################################################################
....................................................................................................
....................................................................................................
....................................................................................................
....................................................................................................
....................................................................................................
....................................................................................................
....................................................................................................
....................................................................................................
....................................................................................................
....................................................................................................
